1OOOOOOOO2
3 O    O O
4 . OO X O
O O O    O
O OOOO O.O
O O O    U
O OOOOOO.O
O O      O
O O OOOOOO
O . O    O
2OOOOOOOO1